Rbr.županije;Županija;Oznaka GROP;Grad/općina;Rbr BM;Naziv BM;Lokacija BM;Adresa BM;Ukupno birača;Glasovalo birača;Glasovalo birača (po listićima);Važeći listići;Nevažeći listići;KRISTINA IKIĆ BANIČEK;ŽELJKA JOSIĆ
03;SISAČKO-MOSLAVAČKA ŽUPANIJA;grad;SISAK;001;SISAK;PROSTORIJE GRADSKE ČETVRTI CENTAR;IVANA MEŠTROVIĆA 32;895;453;453;430;23;245;185
03;SISAČKO-MOSLAVAČKA ŽUPANIJA;grad;SISAK;002;SISAK;PROSTORIJE DRUŠTVA GLUHIH I NAGLUHIH GRADA SISKA;TRG 22. LIPNJA 4B;499;261;261;253;8;154;99
03;SISAČKO-MOSLAVAČKA ŽUPANIJA;grad;SISAK;003;SISAK;OSNOVNA ŠKOLA 22. LIPNJA;FRANJE LOVRIĆA 27 (UMJESTO U ZGRADI SISAČKO-MOSLAVAČKE ŽUPANIJE, S. I A. RADIĆA 36);481;235;235;226;9;118;108
03;SISAČKO-MOSLAVAČKA ŽUPANIJA;grad;SISAK;004;SISAK;OSNOVNA ŠKOLA 22. LIPNJA;FRANJE LOVRIĆA 27 (UMJESTO U ZGRADI SISAČKO-MOSLAVAČKE ŽUPANIJE, S. I A. RADIĆA 36);439;230;230;224;6;113;111
03;SISAČKO-MOSLAVAČKA ŽUPANIJA;grad;SISAK;005;SISAK;NARODNA KNJIŽNICA I ČITAONICA VLADO GOTOVAC SISAK;RIMSKA 27;533;279;279;269;10;112;157
03;SISAČKO-MOSLAVAČKA ŽUPANIJA;grad;SISAK;006;SISAK;PROSTORIJE GRADSKOG DRUŠTVA CRVENOG KRIŽA SISAK;ULICA KRALJA TOMISLAVA 18;639;376;376;364;12;159;205
03;SISAČKO-MOSLAVAČKA ŽUPANIJA;grad;SISAK;007;SISAK;PROSTORIJE ZAVODA ZA ZAPOŠLJAVANJE;UL. KRALJA TOMISLAVA 13;538;294;294;278;16;158;120
03;SISAČKO-MOSLAVAČKA ŽUPANIJA;grad;SISAK;008;SISAK;PROSTORIJE GRADSKE ČETVRTI ZELENI BRIJEG;FRANA KRŠINIĆA 19;551;263;263;256;7;148;108
03;SISAČKO-MOSLAVAČKA ŽUPANIJA;grad;SISAK;009;SISAK;DJEČJI VRTIĆ PČELICA;ULICA ANTUNA CUVAJA 3;910;409;409;395;14;218;177
03;SISAČKO-MOSLAVAČKA ŽUPANIJA;grad;SISAK;010;SISAK;PROSTORIJE BIVŠE POSLOVNICE ALIANZ OSIGURANJE;MARIJANA CELJAKA 79;1217;552;552;544;8;237;307
03;SISAČKO-MOSLAVAČKA ŽUPANIJA;grad;SISAK;011;SISAK;OSNOVNA ŠKOLA BRAĆA RIBAR SISAK;ZAGREBAČKA 8A;535;286;286;275;11;152;123
03;SISAČKO-MOSLAVAČKA ŽUPANIJA;grad;SISAK;012;SISAK;OSNOVNA ŠKOLA BRAĆA RIBAR SISAK;ZAGREBAČKA 8A;749;321;321;312;9;169;143
03;SISAČKO-MOSLAVAČKA ŽUPANIJA;grad;SISAK;013;SISAK;PROSTORIJE GRADSKE ČETVRTI ZELENI BRIJEG;FRANA KRŠINIĆA 19;630;277;277;274;3;153;121
03;SISAČKO-MOSLAVAČKA ŽUPANIJA;grad;SISAK;014;SISAK;OSNOVNA ŠKOLA BRAĆA RIBAR SISAK;ZAGREBAČKA 8A;659;324;324;315;9;181;134
03;SISAČKO-MOSLAVAČKA ŽUPANIJA;grad;SISAK;015;SISAK;PROSTORIJE AMBULANTE;FERDE HEFELEA 10;807;389;389;370;19;189;181
03;SISAČKO-MOSLAVAČKA ŽUPANIJA;grad;SISAK;016;SISAK;PROSTORIJE DRUŠTVENOG DOMA VIKTOROVAC;PERIVOJ VIKTOROVAC BB;650;292;292;286;6;158;128
03;SISAČKO-MOSLAVAČKA ŽUPANIJA;grad;SISAK;017;SISAK;ŠATOR NA JAVNOJ POVRŠINI PREKO PUTA BIVŠE STRUKOVNE ŠKOLE SISAK;LAĐARSKA 1;604;343;343;330;13;148;182
03;SISAČKO-MOSLAVAČKA ŽUPANIJA;grad;SISAK;018;SISAK;ŠATOR NA JAVNOJ POVRŠINI PREKO PUTA BIVŠE STRUKOVNE ŠKOLE SISAK;LAĐARSKA 1;740;353;353;340;13;161;179
03;SISAČKO-MOSLAVAČKA ŽUPANIJA;grad;SISAK;019;SISAK;DJEČJI VRTIĆ TRATINČICA;NIKOLE ŠUBIĆA ZRINSKOG 23;733;419;419;406;13;199;207
03;SISAČKO-MOSLAVAČKA ŽUPANIJA;grad;SISAK;020;SISAK;RC ZIBEL - STARI OBJEKT (STOLNOTENISKA DVORANA);ULAZ IZ CESARČEVE ULICE;477;235;235;228;7;122;106
03;SISAČKO-MOSLAVAČKA ŽUPANIJA;grad;SISAK;021;SISAK;OSNOVNA ŠKOLA VIKTOROVAC SISAK;ALEJA NARODNIH HEROJA 2;1148;551;550;535;15;351;184
03;SISAČKO-MOSLAVAČKA ŽUPANIJA;grad;SISAK;022;SISAK;OSNOVNA ŠKOLA VIKTOROVAC SISAK;ALEJA NARODNIH HEROJA 2;1246;646;646;625;21;425;200
03;SISAČKO-MOSLAVAČKA ŽUPANIJA;grad;SISAK;023;SISAK;PROSTORIJE AMBULANTE;AUGUSTA CESARCA 109B;875;441;441;431;10;265;166
03;SISAČKO-MOSLAVAČKA ŽUPANIJA;grad;SISAK;024;SISAK;ŠATOR NA PARKIRALIŠTU ISPRED PROSTORIJA GRADSKE ČETVRTI GALDOVO;GALDOVAČKA ULICA 6;1235;558;558;541;17;261;280
03;SISAČKO-MOSLAVAČKA ŽUPANIJA;grad;SISAK;025;SISAK;OSNOVNA ŠKOLA GALDOVO (U PREDVORJU ŠKOLE);ULICA BREZOVIČKOG ODREDA 1;884;393;393;381;12;175;206
03;SISAČKO-MOSLAVAČKA ŽUPANIJA;grad;SISAK;026;SISAK;OSNOVNA ŠKOLA GALDOVO (ŠKOLSKA DVORANA);ULICA BREZOVIČKOG ODREDA 1;765;348;348;338;10;149;189
03;SISAČKO-MOSLAVAČKA ŽUPANIJA;grad;SISAK;027;SISAK;DRUŠTVENI DOM ( PROSTORIJE PRIJAŠNJEG MO GALDOVO KAPTOLSKO);VLADIMIRA LOGOMERCA 27;1493;727;727;705;22;343;362
03;SISAČKO-MOSLAVAČKA ŽUPANIJA;grad;SISAK;028;SISAK;PROSTORIJE  PRIJAŠNJEG MO CAPRAG;ANDRIJE HEBRANGA 25;1359;615;615;598;17;411;187
03;SISAČKO-MOSLAVAČKA ŽUPANIJA;grad;SISAK;029;SISAK;PROSTORIJE PRIJAŠNJEG MO IVAN BUIĆ;NINE MARAKOVIĆA 4;305;119;119;116;3;86;30
03;SISAČKO-MOSLAVAČKA ŽUPANIJA;grad;SISAK;030;SISAK;PROSTORIJE DJ. VRTIĆA MASLAČAK;HRVATSKOG NARODNOG PREPORODA 33;762;332;332;326;6;233;93
03;SISAČKO-MOSLAVAČKA ŽUPANIJA;grad;SISAK;031;SISAK;NARODNA KNJIŽNICA I ČITAONICA VLADO GOTOVAC - ODJEL CAPRAG;TRG HRVATSKE DRŽAVNOSTI 1;753;330;330;321;9;216;105
03;SISAČKO-MOSLAVAČKA ŽUPANIJA;grad;SISAK;032;SISAK;OSNOVNA ŠKOLA BRAĆA BOBETKO SISAK;MARIJANA CVETKOVIĆA 2;928;412;412;403;9;246;157
03;SISAČKO-MOSLAVAČKA ŽUPANIJA;grad;SISAK;033;SISAK;PROSTORIJE PRIJAŠNJEG MO IVAN BUIĆ;NINE MARAKOVIĆA 4;313;134;134;132;2;91;41
03;SISAČKO-MOSLAVAČKA ŽUPANIJA;grad;SISAK;034;SISAK;DOM INA RAFINERIJE NAFTE SISAK;ANTE KOVAČIĆA 1;337;134;134;126;8;69;57
03;SISAČKO-MOSLAVAČKA ŽUPANIJA;grad;SISAK;035;SISAK;DRUŠTVENI DOM, PROSTORIJE GRADSKE ČETVRTI CAPRAG ( PRIJAŠNJI MO EUGEN KVATERNIK);LASINJSKA UL 15;1313;606;606;587;19;327;260
03;SISAČKO-MOSLAVAČKA ŽUPANIJA;grad;SISAK;036;SISAK;MO CRNAC U ZGRADI BIVŠE PODRUČNE ŠKOLE BRAĆA BOBETKO;ULICA BRAĆE BOBETKO;202;119;119;114;5;29;85
03;SISAČKO-MOSLAVAČKA ŽUPANIJA;grad;SISAK;037;NOVO SELO;PROSTORIJE U VATROGASNOM DOMU DVD-A MLADOST U NOVOM SELU;NOVOSELSKA ULICA 50;504;219;219;213;6;110;103
03;SISAČKO-MOSLAVAČKA ŽUPANIJA;grad;SISAK;038;CAPRAŠKE POLJANE;ROMSKA KUĆA;CAPRAŠKE POLJANE 54;353;218;218;212;6;161;51
03;SISAČKO-MOSLAVAČKA ŽUPANIJA;grad;SISAK;039;NOVO PRAČNO;PROSTORIJE OŠ I.K. SAKCINSKI;NOVO PRAČNO;322;154;154;149;5;54;95
03;SISAČKO-MOSLAVAČKA ŽUPANIJA;grad;SISAK;040;HRASTELNICA;OSNOVNA ŠKOLA GALDOVO - PODRUČNA ŠKOLA HRASTELNICA;HRASTELNICA 85 (UMJESTO U DRUŠTVENOM DOMU MO HRASTELNICA, HRASTELNICA 85A);691;341;341;334;7;162;172
03;SISAČKO-MOSLAVAČKA ŽUPANIJA;grad;SISAK;041;PALANJEK;DRUŠTVENI DOM MO PALANJEK;PALANJEK BB;253;179;179;179;0;136;43
03;SISAČKO-MOSLAVAČKA ŽUPANIJA;grad;SISAK;042;PRELOŠĆICA;PROSTORIJE DVD PRELOŠĆICA;PRELOŠĆICA;416;200;200;198;2;76;122
03;SISAČKO-MOSLAVAČKA ŽUPANIJA;grad;SISAK;043;BUKOVSKO;DRUŠTVENI DOM BUKOVSKO;BUKOVSKO 10;65;26;26;25;1;5;20
03;SISAČKO-MOSLAVAČKA ŽUPANIJA;grad;SISAK;044;KOMAREVO;DRUŠTVENI DOM MO KOMAREVO;GORNJE KOMAREVO 4;629;250;250;242;8;96;146
03;SISAČKO-MOSLAVAČKA ŽUPANIJA;grad;SISAK;045;BLINJSKI KUT;DRUŠTVENI DOM BLINJSKI KUT;BLINJSKI KUT 34 A;240;89;89;88;1;61;27
03;SISAČKO-MOSLAVAČKA ŽUPANIJA;grad;SISAK;046;MADŽARI;DRUŠTVENI DOM MO MADŽARI-LETOVANCI;MADŽARI 30 A;203;127;127;127;0;87;40
03;SISAČKO-MOSLAVAČKA ŽUPANIJA;grad;SISAK;047;KLOBUČAK;ŠATOR NA POVRŠINI POKRAJ PROSTORIJA MO KLOBUČAK - KONTEJNER;KLOBUČAK BB;58;26;26;26;0;23;3
03;SISAČKO-MOSLAVAČKA ŽUPANIJA;grad;SISAK;048;LETOVANCI;DRUŠTVENI DOM ( PROSTORIJE PRIJAŠNJEG MO LETOVANCI);LETOVANCI;46;35;35;35;0;17;18
03;SISAČKO-MOSLAVAČKA ŽUPANIJA;grad;SISAK;049;ODRA;DRUŠTVENI DOM MO ODRA;ODRA SISAČKA 38;638;312;312;307;5;105;202
03;SISAČKO-MOSLAVAČKA ŽUPANIJA;grad;SISAK;050;ŽABNO;PROSTORIJE OSNOVNE ŠKOLE BRAĆA RIBAR SISAK;PODRUČNA ŠKOLA ŽABNO;396;203;203;194;9;66;128
03;SISAČKO-MOSLAVAČKA ŽUPANIJA;grad;SISAK;051;GREDA;"PROSTORIJE O.Š. ""SELA"", PODRUČNI ODJEL GREDA";GREDA;727;338;338;333;5;176;157
03;SISAČKO-MOSLAVAČKA ŽUPANIJA;grad;SISAK;052;JAZVENIK;"DRUŠTVENI DOM ""ČEŠKA BESEDA""";JAZVENIK 7B;111;80;80;77;3;23;54
03;SISAČKO-MOSLAVAČKA ŽUPANIJA;grad;SISAK;053;SELA;OSNOVNA ŠKOLA SELA;SELA;798;371;371;361;10;112;249
03;SISAČKO-MOSLAVAČKA ŽUPANIJA;grad;SISAK;054;STARA DRENČINA;NOVI VATROGASNI DOM DVD-A STARA DRENČINA;STARA DRENČINA 59A (UMJESTO U DRUŠTVENOM DOMU STARA DRENČINA, STARA DRENČINA BB);177;107;107;106;1;42;64
03;SISAČKO-MOSLAVAČKA ŽUPANIJA;grad;SISAK;055;STARO PRAČNO;DRUŠTVENI DOM STARO PRAČNO;STARO PRAČNO 10;737;360;360;343;17;148;195
03;SISAČKO-MOSLAVAČKA ŽUPANIJA;grad;SISAK;056;STUPNO;DRUŠTVENI DOM MO STUPNO;STUPNO 58;403;206;206;200;6;71;129
03;SISAČKO-MOSLAVAČKA ŽUPANIJA;grad;SISAK;057;VUROT;DRUŠTVENI DOM MO VUROT;VUROT 33A;102;35;35;33;2;18;15
03;SISAČKO-MOSLAVAČKA ŽUPANIJA;grad;SISAK;058;BUDAŠEVO;OSNOVNA ŠKOLA BUDAŠEVO - TOPOLOVAC - GUŠĆE;TRG MARIJANA ŠOKČEVIĆA 1 (UMJESTO U DRUŠTVENOM DOMU MO BUDAŠEVO, TRG MARIJANA ŠOKČEVIĆA 3);1320;585;585;563;22;215;348
03;SISAČKO-MOSLAVAČKA ŽUPANIJA;grad;SISAK;059;NOVO SELO PALANJEČKO;DRUŠTVENI DOM MO NOVO SELO PALANJEČKO;NOVO SELO PALANJEČKO BB;463;195;195;190;5;80;110
03;SISAČKO-MOSLAVAČKA ŽUPANIJA;grad;SISAK;060;TOPOLOVAC;PROSTORIJE NOGOMETNOG KLUBA TŠK, TOPOLOVAC;TRG HRVATSKIH DRAGOVOLJACA 1A (UMJESTO U DRUŠTVENOM DOMU MO TOPOLOVAC, TRG HRVATSKIH DRAGOVOLJACA 1);739;347;347;335;12;118;217
03;SISAČKO-MOSLAVAČKA ŽUPANIJA;grad;SISAK;061;LUKAVEC POSAVSKI;DRUŠTVENI DOM MO LUKAVEC POSAVSKI;LUKAVEC POSAVSKI 1C;100;53;53;53;0;23;30
03;SISAČKO-MOSLAVAČKA ŽUPANIJA;grad;SISAK;062;GUŠĆE;MO GUŠĆE U ZGRADI DVD GUŠĆE;GUŠĆE 105;292;129;129;128;1;68;60
03;SISAČKO-MOSLAVAČKA ŽUPANIJA;grad;SISAK;063;ČIGOĆ;PROSTORIJE DOBROVOLJNOG VATROGASNOG DRUŠTVA ČIGOĆ;ČIGOĆ 16;62;27;27;27;0;10;17
03;SISAČKO-MOSLAVAČKA ŽUPANIJA;grad;SISAK;064;KRATEČKO;DRUŠTVENI DOM MO KRATEČKO;KRATEČKO 96;149;79;79;77;2;32;45
03;SISAČKO-MOSLAVAČKA ŽUPANIJA;grad;SISAK;065;MUŽILOVČICA;VATROGASNI DOM MUŽILOVČICA;MUŽILOVČICA;67;38;38;38;0;20;18
03;SISAČKO-MOSLAVAČKA ŽUPANIJA;grad;SISAK;066;SUVOJ;DRUŠTVENI DOM (PROSTORIJE PRIJAŠNJEG MO SUVOJ);SUVOJ;27;20;20;18;2;14;4
03;SISAČKO-MOSLAVAČKA ŽUPANIJA;grad;SISAK;067;LONJA;PROSTORIJE DVD-A LONJA;LONJA BB;84;30;30;30;0;15;15
03;SISAČKO-MOSLAVAČKA ŽUPANIJA;grad;SISAK;068;SVINJIČKO;PROSTORIJE MO VELIKO SVINJIČKO U PODRUČNOJ ŠKOLI;VELIKO SVINJIČKO 105;190;92;92;90;2;43;47
03;SISAČKO-MOSLAVAČKA ŽUPANIJA;grad;SISAK;069;STARO SELO;KUĆA MILOŠA ĐUKIĆA;STARO SELO 61;108;42;42;41;1;39;2
