Rbr.županije;Županija;Oznaka GROP;Grad/općina;Rbr BM;Naziv BM;Lokacija BM;Adresa BM;Ukupno birača;Glasovalo birača;Glasovalo birača (po listićima);Važeći listići;Nevažeći listići;DAMIR JUZBAŠIĆ;DAVOR MILIČEVIĆ
16;VUKOVARSKO-SRIJEMSKA ŽUPANIJA;grad;ŽUPANJA;001;ŽUPANJA;"OŠ ""IVAN KOZARAC"" I";DR. FRANJE RAČKOG 30;923;461;461;452;9;255;197
16;VUKOVARSKO-SRIJEMSKA ŽUPANIJA;grad;ŽUPANJA;002;ŽUPANJA;"OŠ ""IVAN KOZARAC"" II";DR.FRANJE RAČKOG 30;807;378;378;366;12;261;105
16;VUKOVARSKO-SRIJEMSKA ŽUPANIJA;grad;ŽUPANJA;003;ŽUPANJA;ZGRADA SREDNJIH ŠKOLA I;VELIKI KRAJ 42;918;409;409;404;5;254;150
16;VUKOVARSKO-SRIJEMSKA ŽUPANIJA;grad;ŽUPANJA;004;ŽUPANJA;ZGRADA SREDNJIH ŠKOLA II;VELIKI KRAJ 42;474;206;206;202;4;123;79
16;VUKOVARSKO-SRIJEMSKA ŽUPANIJA;grad;ŽUPANJA;005;ŽUPANJA;ZGRADA SREDNJIH ŠKOLA III;VELIKI KRAJ 42;640;290;290;285;5;193;92
16;VUKOVARSKO-SRIJEMSKA ŽUPANIJA;grad;ŽUPANJA;006;ŽUPANJA;ŠUMARIJA I;DR.FRANJE RAČKOG 34;750;405;405;396;9;246;150
16;VUKOVARSKO-SRIJEMSKA ŽUPANIJA;grad;ŽUPANJA;007;ŽUPANJA;ŠUMARIJA II;DR.FRANJE RAČKOG 34;777;415;413;396;17;258;138
16;VUKOVARSKO-SRIJEMSKA ŽUPANIJA;grad;ŽUPANJA;008;ŽUPANJA;"KINO ""MLADOST"" I";STROSMAYEROVA 51;522;296;296;291;5;196;95
16;VUKOVARSKO-SRIJEMSKA ŽUPANIJA;grad;ŽUPANJA;009;ŽUPANJA;"KINO ""MLADOST"" II";STROSSMAYEROVA 51;671;335;335;329;6;236;93
16;VUKOVARSKO-SRIJEMSKA ŽUPANIJA;grad;ŽUPANJA;010;ŽUPANJA;"OSNOVNA ŠKOLA ""MATE LOVRAK"" I";A.STEPINCA 18;1078;505;505;489;16;315;174
16;VUKOVARSKO-SRIJEMSKA ŽUPANIJA;grad;ŽUPANJA;011;ŽUPANJA;"OSNOVNA ŠKOLA ""MATE LOVRAK"" II";A.STEPINCA 18;804;360;360;351;9;189;162
16;VUKOVARSKO-SRIJEMSKA ŽUPANIJA;grad;ŽUPANJA;012;ŽUPANJA;"OSNOVNA ŠKOLA ""MATE LOVRAK"" III";A.STEPINCA 18;935;430;430;417;13;267;150
16;VUKOVARSKO-SRIJEMSKA ŽUPANIJA;grad;ŽUPANJA;013;ŽUPANJA;"KINO ""KRISTAL""";ŠEĆERANA 62;663;339;339;334;5;167;167
16;VUKOVARSKO-SRIJEMSKA ŽUPANIJA;grad;ŽUPANJA;014;ŽUPANJA;"PROSTORIJE NK ""ŽUPANJA 77""";M.ĆATIĆA;553;249;249;246;3;117;129
